Alexei Sourin	computer_graphics;cybermedicine;scientific_visualization;shape_modelling;virtual_reality;visualization_on_the_grid;web_visualization;
Anupam Chattopadhyay	application_specific_processors;heterogeneous_mpsoc;high_level_synthesis;synthesis_for_emerging_technology;
Anwitaman Datta	algorithms;data_analytics;distributed_systems;security_and_privacy;self_organization;
Arijit Khan	algorithms;data_mining;databases;graphs_querying_and_mining;machine_learning;
Arvind Easwaran	cyber_physical_systems;formal_methods;real_time_systems;
AS Madhukumar	communication_algorithms;digital_signal_processing;modulation_and_multiple_access;ultra_wideband_radio;
Bo An	game_theory;intelligent__e-commerce;multi_agent_systems;optimization;
Cai Jianfei	image_coding;multimedia_networking;video_coding;wireless_video;
Cai Wentong	parallel_algorithms_and_architectures;parallel_and_distributed_simulation;programming_environments_and_tools;system_performance_analysis;
Cham Tat Jen	computer_vision;intelligent_projector_presentation_systems;interactive_sentient_environments;semantic_transcoding_of_video_streams;
Chan Syin	image_compression;model_based_coding;multimedia_information_retrieval;video_compression;
Chia Liang Tien Clement	multimedia_adaptation;multimedia_analysis;multimedia_annotation;multimedia_processing;multimedia_transmission;multimedia_understanding_for_information_management;multimodality_data_fusion_for_multimedia_storage_and_retrieval;ontology_support_for_multimedia_semantic_web;
Chng Eng Siong	digital_signal_processing;noise_reduction;speech_and_handwriting_recognition;
Deepu Rajan	image_processing;medical_imaging_image_compression;multimedia_signal_processing;video_compression;video_processing_computer_vision;
Deng Ruilong	cyber_physical_systems;cyber_security;wireless_networking;
Douglas Leslie Maskell	embedded_systems;signal_processing_applications;
Dusit Niyato	economics_modeling_of_wireless_communications_and_networking;network_performance_analysis;radio_resource_management;
Eric Cambria	common_sense_reasoning;intention_awareness;natural_language_processing;sentiment_analysis;
Gao Cong	data_mining_large_scale_data_analytics;geospatial_textual_and_mobility_data_management;mining_social_networks_and_social_media;urban_informatics;user_preference_modeling_and_recommendation;
Goh Wooi Boon	computer_vision;human_computer_interaction;interactive_multimedia;
Guan Cuntai	brain_computer_interfaces;cognition_and_rehabilitation;machine_learning;neural_engineering;
He Ying	computer_graphics;geometric_modeling;scientific_computing;visualization;
Huang Shell Ying	algorithms_and_data_structure;multi_agent_systems;navigation_and_route_planning_systems;
Hui Siu Cheung	data_mining;intelligent_techniques;scheduling;semantic_web;
Jagath C. Rajapakse	brain_imaging;computational_and_systems_biology;machine_learning;
Ke Yiping Kelly	big_data_analytics;bioinformatics;data_management;data_mining;
Kong Wai Kin Adams	biometric_security;computer_vision;image_processing;pattern_recognition;
Kwoh Chee Keong	classification_and_augmented_reality;medical_image_processing_lesion_identification;probabilistic_inference;
Lam Kwok Yan	biometric_cryptography;critical_information_infrastructure_protection;cyber_security;distributed_systems_security;enterprise_architecture;multi_modal_biometrics_in_homeland_security;
Lam Siew Kei	custom_computing;embedded_vision;heterogeneous_and_reconfigurable_systems;high_level_synthesis;
Lau Chiew Tong	embedded_systems;wireless_communications;
Lee Bu Sung Francis	cloud_computing;grid_computing;quality_of_service;sdn_in_computer_network;wireless_ad_hoc_network;
Li Fang Flora	biomedical_engineering_related_research;biometric_image_processing;pattern_recognition;
Li Mo	distributed_systems;pervasive_computing;real_time_and_embedded_systems;wireless_sensor_networks;
Li Yi	automated_reasoning;formal_methods;program_analysis;software_engineering;
Liang Qianhui Althea	graph_based_search;machine_learning;neural_networks;service_and_cloud_computing;
Lin Feng	computer_graphics;high_performance_computing;medical_informatics;visualisation;
Lin Guosheng	computer_vision;machine_learning;
Lin Shang Wei	compositional_verification_and_synthesis;embedded_real_time_system_verification_and_synthesis;formal_methods;model_checking;program_verification_and_synthesis;
Lin Weisi	image_processing;multimedia_communication;object_recognition;perceptual_visual_quality_gauging;
Liu Weichen	computer_architecture;electronic_network_on_chip;embedded_and_real_time_systems;many_core_systems;photonic_network_on_chip;
Liu Yang	formal_methods;model_checking;software_engineering;software_security;
Loke Yuan Ren	computer_vision;embedded_vision_system;image_processing;machine_learning;
Long Cheng	artificial_intelligence;big_data;distributed_graph_computing;spatio_temporal_data_management_and_mining;urban_computing;
Loy Chen Change (Cavan)	computer_vision;deep_learning;image_processing;machine_learning;
Lu Shijian	cognitive_vision;image_and_video_analytics;machine_learning;visual_intelligence;
Luo Jun	applied_operations_research;network_modeling_and_performance_evaluation;network_security;wireless_networking;
Mahardhika Pratama	autonomous_systems;data_stream_analytics;evolving_and_adaptive_systems;fuzzy_machine_learning;tool_condition_monitoring;
Miao Chunyan	agent_oriented_software_engineering;mas;semantic_grid;semantic_web;software_agent;
Mohamed Mostafa Sabry Aly	computer_architecture;emerging_technologies;system_level_design;
Ng Wee Keong	computational_airspace_utilization;enterprise_blockchain_applications;privacy_preserving_machine_learning;risk_modeling_systems;
Oh Hong Lye	embedded_systems;internet_of_things;
Ong Yew Soon	artificial_intelligence;computational_intelligence;data_analytics;evolutionary_optimization;intelligent_multi_agents;memetic_computing;
Owen Noel Newton Fernando	entertainment_and_mobile_computing;human_computer_interaction;interactive_systems;multimodal_and_natural_interfaces;
Pan Jialin Sinno	data_mining;machine_learning;recommender_systems;social_media_analytics;transfer_learning;
Qian Kemao	augmented_reality;computer_animation;computer_vision;image_analysis_and_processing;optical_metrology_and_fringe_processing;
Quek Hiok Chai	artificial_intelligence_in_education;fuzzy_neural_systems;intelligent_control;
Seah Hock Soon	automatic_in_between_frame_generation_from_hand_drawn_sketches;digital_dynamic_visualization;image_sequence_analysis_with_applications_to_digital_film_effects;medical_visualization;
Shafiq Joty	data_science;deep_learning;graphical_models;machine_learning;medical_informatics;natural_language_processing;reinforcement_learning;
Smitha Kavallur Pisharath Gopi	brain_computer_interface;embedded_systems;low_power_reconfigurable_computing;signal_processing_applications;
Sourav Saha Bhowmick	computational_social_science;computational_systems_biology;data_analytics;data_management;
Sourav Sen Gupta	cryptology;cyber_security;data_science;number_theory;
Srikanthan Thambipillai	embedded_systems;hardware_accelerators;high_speed_arithmetic_units;
Sun Aixin	digital_libraries;information_retrieval;social_computing;text_mining;web_mining;
Sun Chengzheng	collaborative_cad_and_case_systems;collaborative_internet_computing_technologies_and_applications;collaborative_office_applications;collaborative_virtual_environments;computer_supported_cooperative_work;distributed_and_network_systems;human_computer_interaction_technology;
Svetlana Obraztsova	computational_economics;computational_social_choice;game_theory;
Ta Nguyen Binh Duong	cloud_computing;computer_networking;distributed_virtual_environments;green_computing;software_security;
Tan Ah Hwee	document_information_mining;intelligent_agents;machine_learning_and_knowledge_discovery;personalization;
Tan Kheng Leong	clustered_ha_systems;enterprise_mobility_platform;software_and_system_security;software_engineering;
Tan Rui	cyber_physical_systems;pervasive_computing;sensor_networks;
Tang Xueyan	distributed_systems;mobile_and_pervasive_computing;web_and_internet;wireless_sensor_networks;
Tay Kian Boon	discrete_math;infocomm_security;mathematical_analysis;public_key_algorithms;
Vanessa Evers	cultural_aspects_of_human_media_interaction;human_robot_interaction;interaction_design_of_ai_agents_and_systems;social_artificial_intelligence;
Vun Chan Hua Nicholas	embedded_signal_conversion_and_signal_processing;embedded_systems;
Wen Yonggang	big_data_systems_and_applications;blockchain_protocols_and_applications;cloud_computing_and_data_centre;distributed_machine_learning;multimedia_computing_and_networking;
Xavier Bresson	artificial_intelligence;computer_vision;data_science;deep_learning;sparse_convex_optimization;spectral_graph_theory;
Yeo Chai Kiat	ad_hoc_and_mobile_networks;overlay_networks;speech_processing_and_enhancement;
Yu Han	crowdsourcing_and_human_computation;data_driven_algorithmic_management;ethically_aligned_intelligent_decision_support;
Zhang Hanwang	computer_vision;multimedia;
Zhang Jie	artificial_intelligence;incentive_mechanism;multi_agent_system;trust_management;
Zhao Jun	artificial_intelligence;machine_learning;networked_systems;security_and_privacy;
Zheng Jianmin	animation_and_visualization;cad;cagd_and_geometric_modeling;cam;computer_graphics;image_processing;
Zinovi Rabinovich	artificial_intelligence;modelling_of_manipulative_interaction;multi_agent_systems;
